summary_date,bedtime_end,bedtime_start,duration,total,awake,rem,deep,light,efficiency,restless,onset_latency,hr_average,hr_lowest,rmssd,score,bedtime_start_delta,bedtime_end_delta,temperature_delta,pct_hr_avrage
2021-08-28,2021-08-29T07:43:43,2021-08-28T22:43:43,32400,28260,4140,5670,7080,15510,87,50,420,57.93,50.0,75,80,-4577,27823,0.02,
2021-08-29,2021-08-30T07:17:52,2021-08-29T21:22:52,35700,30270,5430,3480,5910,20880,85,48,930,61.21,50.0,60,82,-9428,26272,-0.27,0.0566200586915242
2021-08-30,2021-08-31T08:05:18,2021-08-30T22:03:18,36120,30090,6030,5280,6720,18090,83,42,540,54.47,48.0,82,83,-7002,29118,-0.33,-0.11011272667864735
2021-08-31,2021-09-01T06:31:31,2021-08-31T21:32:31,32340,26010,6330,3420,6720,15870,80,41,1530,57.8,51.0,75,74,-8849,23491,0.14,0.06113456948779139
2021-09-01,2021-09-02T07:37:04,2021-09-01T21:31:04,36360,32160,4200,6750,7050,18360,88,41,630,56.65,49.0,73,91,-8936,27424,-0.07,-0.019896193771626325
2021-09-02,2021-09-03T07:54:17,2021-09-02T21:15:17,38340,34290,4050,9750,5280,19260,89,46,600,55.65,49.0,74,90,-9883,28457,-0.04,-0.017652250661959412
2021-09-03,2021-09-04T09:00:08,2021-09-03T22:34:08,37560,29700,7860,5640,4980,19080,79,43,690,59.55,52.0,65,78,-5152,32408,-0.23,0.07008086253369261
2021-09-04,2021-09-05T08:27:33,2021-09-04T22:38:33,35340,29070,6270,6750,4680,17640,82,41,1560,60.93,52.0,70,79,-4887,30453,-0.06,0.023173803526448378
2021-09-05,2021-09-06T07:36:40,2021-09-05T21:25:40,36660,31410,5250,8430,5340,17640,86,41,1350,61.32,53.0,65,87,-9260,27400,0.3,0.006400787789266449
2021-09-06,2021-09-07T07:36:22,2021-09-06T21:37:22,35940,31110,4830,7530,5250,18330,87,46,1230,60.17,53.0,61,88,-8558,27382,0.22,-0.01875407697325504
2021-09-07,2021-09-08T07:01:59,2021-09-07T21:35:59,33960,27870,6090,5190,5160,17520,82,46,2160,59.74,52.0,70,74,-8641,25319,-0.01,-0.007146418480970529
2021-09-08,2021-09-09T07:22:09,2021-09-08T21:35:09,35220,30510,4710,6510,5850,18150,87,50,360,58.55,51.0,72,85,-8691,26529,0.19,-0.019919651824573226
2021-09-09,2021-09-10T07:57:44,2021-09-09T21:34:44,37380,33570,3810,6480,6000,21090,90,46,780,57.08,51.0,74,91,-8716,28664,-0.08,-0.02510674637062338
2021-09-10,2021-09-11T09:15:46,2021-09-10T23:44:46,34260,28920,5340,4020,6360,18540,84,46,480,61.87,53.0,76,74,-914,33346,0.04,0.08391730903994388
2021-09-11,2021-09-12T07:40:01,2021-09-11T22:06:01,34440,30420,4020,6270,5310,18840,88,50,1320,58.75,51.0,71,86,-6839,27601,0.31,-0.050428317439793036
2021-09-12,2021-09-13T07:35:35,2021-09-12T21:33:35,36120,30990,5130,6540,3690,20760,86,51,870,58.35,50.0,83,85,-8785,27335,0.13,-0.006808510638297793
2021-09-13,2021-09-14T07:28:46,2021-09-13T21:20:46,36480,31110,5370,5280,4470,21360,85,55,1080,57.04,51.0,75,83,-9554,26926,0.17,-0.022450728363324846
2021-09-14,2021-09-15T07:06:13,2021-09-14T21:22:13,35040,30840,4200,5550,5340,19950,88,54,750,57.29,53.0,71,86,-9467,25573,0.09,0.004382889200561069
2021-09-15,2021-09-16T07:38:50,2021-09-15T21:42:50,35760,30960,4800,6870,8640,15450,87,49,900,59.6,53.0,60,88,-8230,27530,0.26,0.0403211729795776
2021-09-16,2021-09-17T07:19:38,2021-09-16T21:33:38,35160,32250,2910,7620,5460,19170,92,45,930,59.14,51.0,68,91,-8782,26378,0.17,-0.007718120805369155
2021-09-17,2021-09-18T08:00:29,2021-09-17T22:21:29,34740,30180,4560,5970,5430,18780,87,48,870,58.27,50.0,74,84,-5911,28829,0.0,-0.014710855596888672
2021-09-18,2021-09-19T08:17:39,2021-09-19T00:18:39,28740,22230,6510,3600,5580,13050,77,41,1350,66.28,55.0,53,64,1119,29859,-0.21,0.13746353183456317
2021-09-19,2021-09-20T07:22:32,2021-09-19T21:29:32,35580,32070,3510,6570,7320,18180,90,42,570,57.96,52.0,67,89,-9028,26552,-0.03,-0.1255280627640314
2021-09-20,2021-09-21T07:08:40,2021-09-20T21:30:40,34680,31260,3420,6870,5130,19260,90,52,210,57.46,50.0,73,86,-8960,25720,0.11,-0.008626639061421693
2021-09-21,2021-09-22T07:09:39,2021-09-21T21:43:39,33960,31290,2670,6450,6870,17970,92,44,180,58.52,53.0,70,87,-8181,25779,0.06,0.01844761573268361
2021-09-22,2021-09-23T07:29:01,2021-09-22T21:40:01,35340,30780,4560,7560,3990,19230,87,46,1440,59.66,52.0,81,84,-8399,26941,0.19,0.01948051948051943
2021-09-23,2021-09-24T08:14:48,2021-09-23T21:36:48,38280,33150,5130,7830,7170,18150,87,50,150,58.11,52.0,71,87,-8592,29688,-0.13,-0.025980556486758233
2021-09-24,2021-09-25T08:09:29,2021-09-24T22:12:29,35820,28410,7410,5580,7170,15660,79,42,990,61.65,52.0,71,85,-6451,29369,0.25,0.06091894682498711
2021-09-25,2021-09-26T07:51:45,2021-09-25T21:58:45,35580,28410,7170,4530,5160,18720,80,42,1080,56.43,50.0,95,81,-7275,28305,0.02,-0.08467153284671536
2021-09-26,2021-09-27T07:25:55,2021-09-26T21:31:55,35640,30540,5100,5850,5730,18960,86,50,1950,53.79,46.0,102,81,-8885,26755,-0.12,-0.04678362573099415
2021-09-27,2021-09-28T07:31:54,2021-09-27T21:42:54,35340,31110,4230,8130,5640,17340,88,42,960,54.4,49.0,78,90,-8226,27114,-0.29,0.01134039784346541
2021-09-28,2021-09-29T07:24:12,2021-09-28T21:38:12,35160,32460,2700,7530,6090,18840,92,44,510,55.69,51.0,73,92,-8508,26652,-0.23,0.02371323529411762
2021-09-29,2021-09-30T07:27:13,2021-09-29T21:30:13,35820,32460,3360,8190,7620,16650,91,47,540,54.97,50.0,74,91,-8987,26833,-0.13,-0.012928712515711926
2021-09-30,2021-10-01T06:43:41,2021-09-30T21:38:41,32700,27540,5160,7320,4560,15660,84,47,1680,55.44,50.0,69,78,-8479,24221,0.02,0.00855011824631613
2021-10-01,2021-10-02T08:24:10,2021-10-01T22:14:10,36600,30450,6150,6150,4950,19350,83,48,960,57.39,51.0,75,87,-6350,30250,-0.22,0.03517316017316019
2021-10-02,2021-10-03T09:22:03,2021-10-02T22:26:03,39360,31620,7740,6720,5040,19860,80,47,630,60.47,53.0,64,83,-5637,33723,-0.24,0.05366788639135733
2021-10-03,2021-10-04T07:12:49,2021-10-03T22:01:49,33060,29370,3690,5970,4920,18480,89,48,1230,56.93,52.0,67,85,-7091,25969,0.13,-0.05854142550024799
2021-10-04,2021-10-05T12:11:34,2021-10-04T21:26:34,53100,30030,23070,4500,4950,20580,57,50,420,55.91,49.0,79,74,-9206,43894,0.27,-0.017916739855963537
2021-10-05,2021-10-06T11:19:56,2021-10-05T21:17:56,50520,35160,15360,6270,6690,22200,70,48,1020,53.84,49.0,78,86,-9724,40796,0.08,-0.03702378823108554
2021-10-06,2021-10-07T08:53:38,2021-10-07T01:16:38,27420,23970,3450,4890,7620,11460,87,36,450,58.49,53.0,60,71,4598,32018,0.06,0.08636701337295682
2021-10-07,2021-10-08T07:58:52,2021-10-07T21:12:52,38760,33390,5370,7650,7200,18540,86,46,1020,57.43,49.0,73,91,-10028,28732,-0.07,-0.01812275602667124
2021-10-08,2021-10-09T09:00:49,2021-10-08T23:50:49,33000,29220,3780,7410,7260,14550,89,45,390,57.43,52.0,68,82,-551,32449,0.26,0.0
2021-10-09,2021-10-10T08:14:15,2021-10-09T22:57:15,33420,31350,2070,7680,6270,17400,94,50,270,54.53,48.0,78,87,-3765,29655,-0.16,-0.05049625631203203
2021-10-10,2021-10-11T07:15:10,2021-10-10T21:47:10,34080,28470,5610,6210,7260,15000,84,43,1080,58.64,50.0,78,83,-7970,26110,-0.05,0.07537135521731164
2021-10-11,2021-10-12T07:22:44,2021-10-11T21:45:44,34620,29910,4710,5640,5610,18660,86,49,360,58.54,50.0,72,83,-8056,26564,-0.07,-0.0017053206002728416
2021-10-12,2021-10-13T07:32:50,2021-10-12T21:40:50,35520,33390,2130,7500,6750,19140,94,47,570,57.17,51.0,77,92,-8350,27170,0.5,-0.023402801503245585
2021-10-13,2021-10-14T07:19:08,2021-10-13T21:35:08,35040,32160,2880,7350,8250,16560,92,50,900,56.85,50.0,80,91,-8692,26348,0.26,-0.005597341262900124
2021-10-14,2021-10-15T07:20:40,2021-10-14T22:22:40,32280,28560,3720,5220,5040,18300,88,50,240,57.74,50.0,75,80,-5840,26440,0.02,0.015655233069481023
2021-10-15,2021-10-16T08:01:24,2021-10-15T21:56:24,36300,30330,5970,3900,4800,21630,84,51,750,57.67,49.0,83,80,-7416,28884,0.12,-0.001212331139591294
2021-10-16,2021-10-17T08:01:39,2021-10-16T21:55:39,36360,33330,3030,9210,4860,19260,92,51,240,58.97,51.0,66,88,-7461,28899,-0.07,0.02254204959250905
2021-10-17,2021-10-18T07:01:45,2021-10-17T22:12:45,31740,27960,3780,5880,5310,16770,88,45,420,58.27,50.0,68,81,-6435,25305,0.18,-0.01187044259793113
2021-10-18,2021-10-19T07:03:44,2021-10-18T22:12:44,31860,28920,2940,5670,4590,18660,91,48,900,59.5,52.0,67,83,-6436,25424,0.18,0.021108632229277502
2021-10-19,2021-10-20T07:01:04,2021-10-19T21:36:04,33900,28140,5760,4200,6630,17310,83,45,1200,57.23,51.0,79,79,-8636,25264,0.14,-0.0381512605042017
2021-10-20,2021-10-21T07:22:09,2021-10-20T21:44:09,34680,30390,4290,6300,5640,18450,88,47,180,57.63,51.0,71,84,-8151,26529,0.1,0.006989341254586945
2021-10-21,2021-10-22T11:29:55,2021-10-22T00:02:55,41220,30810,10410,7350,5370,18090,75,42,450,71.08,62.0,32,81,175,41395,0.25,0.23338538955405164
2021-10-22,2021-10-23T08:24:29,2021-10-22T22:05:29,37140,30150,6990,5970,5550,18630,81,47,750,63.65,54.0,65,82,-6871,30269,0.4,-0.10453010692177833
2021-10-23,2021-10-24T07:53:22,2021-10-23T21:58:22,35700,31620,4080,6630,5550,19440,89,48,690,57.29,51.0,74,89,-7298,28402,0.08,-0.09992144540455616
2021-10-24,2021-10-25T07:01:09,2021-10-24T21:33:09,34080,29790,4290,6450,2850,20490,87,56,1140,58.97,51.0,66,80,-8811,25269,-0.29,0.02932448943969268
2021-10-25,2021-10-26T07:08:12,2021-10-25T21:26:12,34920,30210,4710,7710,6180,16320,87,48,960,55.57,50.0,78,87,-9228,25692,-0.12,-0.05765643547566557
2021-10-26,2021-10-27T07:09:00,2021-10-26T21:35:00,34440,28950,5490,5310,5160,18480,84,45,1620,55.29,49.0,73,80,-8700,25740,0.06,-0.005038689940615515
2021-10-27,2021-10-28T07:01:47,2021-10-27T21:58:47,32580,26400,6180,5640,3990,16770,81,42,1740,59.72,52.0,55,75,-7273,25307,-0.32,0.08012298788207639
2021-10-28,2021-10-29T07:24:03,2021-10-28T21:16:03,36480,30720,5760,7470,4920,18330,84,44,1170,60.1,53.0,61,86,-9837,26643,-0.65,0.006363027461486981
2021-10-29,2021-10-30T08:17:32,2021-10-29T22:06:32,36660,31380,5280,8610,4050,18720,86,46,1050,66.58,55.0,51,85,-6808,29852,-0.26,0.10782029950083194
2021-10-30,2021-10-31T06:52:07,2021-10-30T21:39:07,33180,29700,3480,6990,7110,15600,90,48,1290,58.6,52.0,67,86,-8453,24727,-0.38,-0.11985581255632316
2021-10-31,2021-11-01T07:02:02,2021-10-31T21:27:02,34500,30840,3660,7260,6000,17580,89,44,750,63.41,57.0,52,89,-9178,25322,0.38,0.08208191126279862
2021-11-01,2021-11-02T07:01:39,2021-11-01T21:14:39,35220,31020,4200,7740,5940,17340,88,48,1320,62.79,55.0,52,89,-9921,25299,0.31,-0.009777637596593558
2021-11-02,2021-11-03T07:01:05,2021-11-02T21:38:05,33780,30000,3780,7020,5070,17910,89,48,390,60.05,53.0,61,84,-8515,25265,0.32,-0.04363752189839154
2021-11-03,2021-11-04T07:15:25,2021-11-03T21:35:25,34800,29100,5700,5970,7080,16050,84,48,630,61.2,54.0,60,84,-8675,26125,0.36,0.019150707743547102
2021-11-04,2021-11-05T07:43:30,2021-11-04T21:25:30,37080,31770,5310,6630,6570,18570,86,46,1170,59.54,53.0,59,89,-9270,27810,0.08,-0.027124183006535962
2021-11-05,2021-11-06T09:07:22,2021-11-06T01:12:22,28500,26880,1620,5550,5880,15450,94,45,630,63.92,55.0,52,75,4342,32842,0.23,0.07356399059455843
2021-11-06,2021-11-07T09:00:27,2021-11-06T22:03:27,39420,31350,8070,6630,5550,19170,80,52,210,60.95,52.0,63,83,-6993,32427,-0.1,-0.04646433041301623
2021-11-07,2021-11-08T07:14:32,2021-11-07T21:45:32,34140,30030,4110,5760,6960,17310,88,44,780,57.85,52.0,74,86,-8068,26072,0.16,-0.050861361771944225
2021-11-08,2021-11-09T07:16:15,2021-11-08T22:02:15,33240,30210,3030,6210,7170,16830,91,50,600,57.12,51.0,71,88,-7065,26175,0.2,-0.01261884183232509
2021-11-09,2021-11-10T07:16:21,2021-11-09T21:44:21,34320,29160,5160,5310,7380,16470,85,42,930,57.63,52.0,71,87,-8139,26181,-0.1,0.008928571428571619
2021-11-10,2021-11-11T07:21:26,2021-11-10T21:45:26,34560,29130,5430,6570,5010,17550,84,48,2340,60.84,52.0,62,79,-8074,26486,0.01,0.055700156168662085
2021-11-11,2021-11-12T07:15:39,2021-11-11T19:53:39,40920,31560,9360,5790,6600,19170,77,44,1080,60.4,53.0,62,85,-14781,26139,0.05,-0.007232084155161189
2021-11-12,2021-11-13T07:47:23,2021-11-12T21:41:23,36360,32100,4260,6210,5850,20040,88,50,300,62.01,52.0,65,86,-8317,28043,-0.42,0.026655629139072934
2021-11-13,2021-11-14T08:14:12,2021-11-13T22:31:12,34980,30930,4050,8070,4680,18180,88,47,870,64.65,57.0,48,88,-5328,29652,-0.1,0.04257377842283505
2021-11-14,2021-11-15T07:03:36,2021-11-14T22:02:36,32460,28710,3750,6510,5520,16680,88,47,2280,62.11,54.0,61,79,-7044,25416,-0.2,-0.039288476411446394
2021-11-15,2021-11-16T07:00:48,2021-11-15T21:39:48,33660,28710,4950,7410,5340,15960,85,44,690,63.19,55.0,56,84,-8412,25248,0.34,0.01738850426662375
2021-11-16,2021-11-17T07:00:56,2021-11-16T21:34:56,33960,30120,3840,6060,6750,17310,89,44,660,59.43,53.0,68,86,-8704,25256,0.16,-0.059503085931318256
2021-11-17,2021-11-18T07:07:38,2021-11-17T22:02:38,32700,28050,4650,4740,6180,17130,86,43,180,59.19,55.0,66,78,-7042,25658,-0.1,-0.004038364462392807
2021-11-18,2021-11-19T07:13:09,2021-11-18T21:35:09,34680,31290,3390,6720,6540,18030,90,50,300,61.8,54.0,60,87,-8691,25989,0.07,0.04409528636594029
2021-11-19,2021-11-20T07:57:39,2021-11-19T20:51:39,39960,31740,8220,6390,5820,19530,79,46,360,64.65,56.0,56,84,-11301,28659,0.41,0.04611650485436902
2021-11-20,2021-11-21T09:34:58,2021-11-21T00:44:58,31800,24840,6960,5280,5190,14370,78,43,1530,68.0,57.0,50,69,2698,34498,0.1,0.05181747873163167
2021-11-21,2021-11-22T07:06:20,2021-11-21T21:31:20,34500,30210,4290,7740,6510,15960,88,45,2160,59.61,52.0,75,84,-8920,25580,0.2,-0.1233823529411765
2021-11-22,2021-11-23T07:10:55,2021-11-22T21:26:55,35040,30540,4500,5340,6540,18660,87,43,780,58.11,52.0,73,86,-9185,25855,-0.14,-0.02516356316054358
2021-11-23,2021-11-24T07:15:25,2021-11-23T21:50:25,33900,30870,3030,7320,7500,16050,91,41,360,59.55,53.0,65,89,-7775,26125,-0.35,0.0247805885389778
2021-11-24,2021-11-25T07:21:17,2021-11-24T22:03:17,33480,28650,4830,6300,5880,16470,86,43,750,58.72,51.0,63,84,-7003,26477,0.02,-0.013937867338371102
2021-11-25,2021-11-26T07:30:39,2021-11-25T21:48:39,34920,28500,6420,5370,7320,15810,82,41,1230,61.08,53.0,71,81,-7881,27039,-0.12,0.04019073569482279
2021-11-26,2021-11-27T08:30:03,2021-11-26T21:51:03,38340,31620,6720,6690,5100,19830,82,43,1680,62.69,55.0,57,82,-7737,30603,-0.24,0.026358873608382405
2021-11-27,2021-11-28T10:00:34,2021-11-28T01:48:34,29520,25290,4230,4920,4200,16170,86,46,540,68.62,62.0,37,77,6514,36034,-0.51,0.0945924389854842
2021-11-28,2021-11-29T07:07:57,2021-11-28T21:42:57,33900,30180,3720,6990,6360,16830,89,42,360,62.71,55.0,63,87,-8223,25677,-0.08,-0.08612649373360537
2021-11-29,2021-11-30T07:11:34,2021-11-29T21:49:34,33720,30810,2910,7770,5580,17460,91,42,1290,64.37,59.0,53,90,-7826,25894,0.17,0.026471057247647867
2021-11-30,2021-12-01T07:09:00,2021-11-30T21:59:00,33000,28560,4440,6390,7110,15060,87,35,1470,62.08,55.0,57,84,-7260,25740,-0.02,-0.03557557868572325
2021-12-01,2021-12-02T07:28:35,2021-12-01T21:42:35,35160,31290,3870,7740,6870,16680,89,30,2610,62.27,56.0,53,88,-8245,26915,0.01,0.003060567010309434
2021-12-02,2021-12-03T07:17:52,2021-12-02T21:51:52,33960,27990,5970,6060,6420,15510,82,41,2040,63.27,53.0,58,78,-7688,26272,0.14,0.016059097478721585
2021-12-03,2021-12-04T11:41:52,2021-12-04T02:06:52,34500,27510,6990,6390,7080,14040,80,26,1230,70.04,62.0,43,74,7612,42112,0.14,0.10700173858068607
2021-12-04,2021-12-05T08:47:16,2021-12-04T21:39:16,40080,34470,5610,10200,7170,17100,86,35,450,63.19,55.0,55,90,-8444,31636,0.13,-0.09780125642490012
2021-12-05,2021-12-06T08:35:46,2021-12-05T22:18:46,37020,31440,5580,7350,8100,15990,85,30,240,64.38,55.0,56,88,-6074,30946,0.21,0.018832093685709816
2021-12-06,2021-12-07T08:13:57,2021-12-06T22:06:57,36420,31020,5400,7230,6780,17010,85,30,1470,64.0,55.0,61,86,-6783,29637,0.01,-0.005902454178316141
2021-12-07,2021-12-08T07:22:33,2021-12-07T22:05:33,33420,30180,3240,6360,6840,16980,90,40,30,61.0,56.0,63,90,-6867,26553,-0.04,-0.046875
2021-12-08,2021-12-09T07:08:13,2021-12-08T21:58:13,33000,29550,3450,6960,5640,16950,90,28,540,60.82,51.0,67,88,-7307,25693,-0.07,-0.0029508196721311775
2021-12-09,2021-12-10T07:41:40,2021-12-09T21:48:40,35580,31800,3780,7440,8730,15630,89,31,360,61.28,53.0,64,90,-7880,27700,-0.02,0.007563301545544299
2021-12-10,2021-12-11T08:04:30,2021-12-10T22:30:30,34440,29790,4650,5400,7710,16680,86,34,270,60.44,53.0,62,83,-5370,29070,0.1,-0.013707571801566676
2021-12-11,2021-12-12T08:34:49,2021-12-11T22:12:49,37320,31680,5640,7680,7320,16680,85,33,480,59.83,51.0,65,89,-6431,30889,0.08,-0.010092653871608182
2021-12-12,2021-12-13T07:14:33,2021-12-12T21:56:33,33480,29490,3990,6780,7800,14910,88,32,1470,59.17,51.0,63,87,-7407,26073,-0.05,-0.011031255223132197
2021-12-13,2021-12-14T07:40:02,2021-12-13T21:12:02,37680,31260,6420,5730,6660,18870,83,38,750,59.73,52.0,70,86,-10078,27602,-0.03,0.00946425553489938
2021-12-14,2021-12-15T07:16:38,2021-12-14T21:40:38,34560,31440,3120,7860,6030,17550,91,33,720,59.25,53.0,62,94,-8362,26198,-0.06,-0.008036162732295238
2021-12-15,2021-12-16T07:20:08,2021-12-15T22:18:08,32520,28950,3570,4980,8190,15780,89,44,270,58.15,52.0,68,86,-6112,26408,0.02,-0.01856540084388192
2021-12-16,2021-12-17T07:01:08,2021-12-16T21:45:08,33360,27120,6240,6150,5910,15060,81,33,1260,59.04,52.0,68,81,-8092,25268,0.11,0.015305245055889927
2021-12-17,2021-12-18T09:23:58,2021-12-17T22:28:58,39300,31770,7530,7740,4890,19140,81,34,780,61.83,51.0,70,85,-5462,33838,0.04,0.047256097560975485
2021-12-18,2021-12-19T09:13:11,2021-12-18T23:31:11,34920,30450,4470,7590,6690,16170,87,37,750,59.2,52.0,64,85,-1729,33191,-0.09,-0.04253598576742679
2021-12-19,2021-12-20T07:27:48,2021-12-19T21:48:48,34740,29490,5250,5760,7800,15930,85,33,750,55.4,49.0,76,86,-7872,26868,0.09,-0.06418918918918926
2021-12-20,2021-12-21T07:18:40,2021-12-20T21:50:40,34080,29340,4740,6360,6330,16650,86,34,420,56.61,49.0,73,88,-7760,26320,-0.33,0.021841155234657128
2021-12-21,2021-12-22T07:21:10,2021-12-21T22:10:10,33060,29580,3480,6720,7830,15030,89,29,450,60.42,51.0,66,88,-6590,26470,-0.13,0.06730259671436145
2021-12-22,2021-12-23T08:12:02,2021-12-22T21:57:02,36900,31350,5550,7440,4740,19170,85,35,1260,62.82,52.0,60,87,-7378,29522,0.1,0.03972194637537241
2021-12-23,2021-12-24T07:36:46,2021-12-23T22:27:46,32940,29640,3300,6840,6810,15990,90,33,870,61.77,53.0,50,89,-5534,27406,-0.1,-0.016714422158548237
2021-12-24,2021-12-25T10:22:20,2021-12-25T01:18:20,32640,28170,4470,6720,4950,16500,86,30,1170,66.81,59.0,43,77,4700,37340,-0.16,0.08159300631374444
2021-12-25,2021-12-26T09:35:05,2021-12-25T23:17:05,37080,33690,3390,7500,8160,18030,91,32,150,61.11,53.0,63,88,-2575,34505,-0.15,-0.08531656937584198
2021-12-26,2021-12-27T08:01:24,2021-12-26T22:46:24,33300,28230,5070,5520,7470,15240,85,31,2310,61.25,55.0,58,77,-4416,28884,0.15,0.002290950744558984
2021-12-27,2021-12-28T09:03:20,2021-12-27T23:00:20,36180,33780,2400,8910,8520,16350,93,29,150,61.36,55.0,54,90,-3580,32600,0.07,0.001795918367346827
2021-12-28,2021-12-29T09:46:16,2021-12-28T23:44:16,36120,31290,4830,6090,5520,19680,87,34,1260,65.97,60.0,49,82,-944,35176,0.13,0.07513037809647982
2021-12-29,2021-12-30T08:34:10,2021-12-29T22:45:10,35340,30480,4860,7140,5040,18300,86,38,840,64.0,55.0,54,85,-4490,30850,-0.17,-0.029862058511444634
2021-12-30,2021-12-31T08:29:01,2021-12-30T22:45:01,35040,30840,4200,6840,7200,16800,88,35,1230,59.75,53.0,67,87,-4499,30541,0.13,-0.06640625
2021-12-31,2022-01-01T06:16:54,2022-01-01T01:27:54,17340,16080,1260,2280,5130,8670,93,28,240,69.46,61.0,40,61,5274,22614,0.11,0.16251046025104587
2022-01-01,2022-01-02T08:54:13,2022-01-01T21:57:13,39420,34620,4800,9210,9660,15750,88,28,1260,65.99,55.0,50,91,-7367,32053,0.28,-0.049956809674632896
2022-01-02,2022-01-03T08:18:47,2022-01-02T21:31:47,38820,33210,5610,8370,6960,17880,86,31,510,66.1,60.0,45,91,-8893,29927,0.25,0.001666919230186359
2022-01-03,2022-01-04T08:43:29,2022-01-03T22:11:29,37920,32670,5250,8010,7020,17640,86,29,270,67.9,61.0,49,88,-6511,31409,0.37,0.027231467473525228
2022-01-04,2022-01-05T08:48:05,2022-01-04T23:15:05,34380,30810,3570,6480,8340,15990,90,29,1080,67.34,61.0,46,87,-2695,31685,0.49,-0.008247422680412453
2022-01-05,2022-01-06T08:50:22,2022-01-05T22:23:22,37620,32160,5460,7500,7230,17430,85,30,540,66.89,58.0,54,88,-5798,31822,-0.13,-0.006682506682506695
2022-01-06,2022-01-07T08:55:58,2022-01-06T22:06:58,38940,34830,4110,9720,7920,17190,89,30,1620,63.21,56.0,56,90,-6782,32158,0.14,-0.05501569741366419
2022-01-07,2022-01-08T08:41:58,2022-01-07T22:59:58,34920,30810,4110,7380,7170,16260,88,33,1080,63.69,58.0,51,88,-3602,31318,-0.23,0.007593735168486049
2022-01-08,2022-01-09T10:10:05,2022-01-09T00:22:05,35280,30990,4290,7890,5280,17820,88,36,660,64.2,57.0,47,82,1325,36605,0.0,0.0080075365049459
2022-01-09,2022-01-10T08:26:42,2022-01-09T22:57:42,34140,28650,5490,6810,6210,15630,84,35,420,57.58,52.0,63,82,-3738,30402,-0.32,-0.10311526479750788
2022-01-10,2022-01-11T08:30:45,2022-01-10T22:08:45,37320,34170,3150,7680,8070,18420,92,32,180,55.32,49.0,79,91,-6675,30645,-0.29,-0.039249739492879465
2022-01-11,2022-01-12T08:11:18,2022-01-11T21:47:18,37440,30960,6480,7080,7140,16740,83,37,1920,54.16,48.0,78,85,-7962,29478,-0.4,-0.020968908170643563
2022-01-12,2022-01-13T08:42:12,2022-01-12T22:10:12,37920,34590,3330,7290,10350,16950,91,35,720,52.88,47.0,88,92,-6588,31332,-0.04,-0.023633677991137247
2022-01-13,2022-01-14T09:02:01,2022-01-13T22:25:01,38220,33810,4410,8490,7140,18180,88,31,810,56.14,48.0,67,92,-5699,32521,0.11,0.06164901664145228
2022-01-14,2022-01-15T08:04:38,2022-01-14T22:58:38,32760,28470,4290,5580,6000,16890,87,34,540,53.86,49.0,75,82,-3682,29078,0.14,-0.04061275382971141
2022-01-15,2022-01-16T08:13:29,2022-01-15T22:35:29,34680,31320,3360,6360,9390,15570,90,33,240,53.29,49.0,87,87,-5071,29609,-0.15,-0.010582992944671354
2022-01-16,2022-01-17T07:56:55,2022-01-16T22:12:55,35040,30030,5010,6120,5100,18810,86,35,2070,52.32,48.0,87,81,-6425,28615,-0.05,-0.01820228936010504
2022-01-17,2022-01-18T07:16:20,2022-01-17T22:26:20,31800,27570,4230,5370,7200,15000,87,31,780,50.6,45.0,86,89,-5620,26180,-0.59,-0.032874617737003065
2022-01-18,2022-01-19T10:11:30,2022-01-18T22:14:30,43020,33090,9930,6240,7680,19170,77,35,1020,54.59,48.0,69,88,-6330,36690,-0.05,0.07885375494071156
2022-01-19,2022-01-20T08:22:41,2022-01-19T22:31:41,35460,30930,4530,6870,6810,17250,87,31,810,55.28,48.0,73,90,-5299,30161,-0.22,0.012639677596629317
2022-01-20,2022-01-21T07:57:14,2022-01-20T22:34:14,33780,29670,4110,6270,8490,14910,88,31,390,54.01,48.0,68,86,-5146,28634,-0.35,-0.022973950795947995
2022-01-21,2022-01-22T09:04:01,2022-01-21T23:06:01,35880,31980,3900,8850,9060,14070,89,27,900,58.17,49.0,60,91,-3239,32641,-0.22,0.07702277356045184
2022-01-22,2022-01-23T08:35:03,2022-01-22T22:29:03,36360,33690,2670,9990,7350,16350,93,28,810,57.16,50.0,63,93,-5457,30903,-0.2,-0.01736290183943623
2022-01-23,2022-01-24T07:03:30,2022-01-23T22:17:30,31560,28020,3540,5190,6480,16350,89,29,810,61.2,53.0,50,84,-6150,25410,0.22,0.07067879636109176
2022-01-24,2022-01-25T07:04:14,2022-01-24T22:08:14,32160,29970,2190,8250,7260,14460,93,29,870,60.3,53.0,54,91,-6706,25454,0.03,-0.014705882352941235
2022-01-25,2022-01-26T07:14:11,2022-01-25T22:08:11,32760,29610,3150,6660,6570,16380,90,31,750,59.82,52.0,69,91,-6709,26051,0.21,-0.007960199004975022
2022-01-26,2022-01-27T07:02:00,2022-01-26T21:46:00,33360,30330,3030,8100,4140,18090,91,29,1050,61.02,54.0,62,88,-8040,25320,0.0,0.02006018054162495
2022-01-27,2022-01-28T07:11:51,2022-01-27T21:28:51,34980,29490,5490,6450,7710,15330,84,31,690,60.12,51.0,72,89,-9069,25911,0.18,-0.014749262536873253
2022-01-28,2022-01-29T08:42:07,2022-01-28T22:09:07,37980,32520,5460,7950,6300,18270,86,33,480,61.44,51.0,71,89,-6653,31327,0.23,0.02195608782435121
2022-01-29,2022-01-30T07:57:14,2022-01-29T22:43:14,33240,30000,3240,7170,7320,15510,90,31,300,58.19,51.0,76,86,-4606,28634,0.12,-0.05289713541666663
2022-01-30,2022-01-31T07:16:56,2022-01-30T22:09:56,32820,29310,3510,5610,5550,18150,89,33,1200,56.66,49.0,81,87,-6604,26216,-0.02,-0.02629317752191096
2022-01-31,2022-02-01T07:07:20,2022-01-31T21:58:20,32940,29730,3210,6660,4410,18660,90,31,660,59.18,51.0,86,86,-7300,25640,0.33,0.044475820684786393
2022-02-01,2022-02-03T07:14:36,2022-02-02T16:39:36,52500,35190,17310,7470,3960,23760,67,35,870,57.71,50.0,78,91,59976,26076,0.08,-0.024839472794863093
2022-02-02,2022-02-03T07:14:36,2022-02-02T22:17:36,32220,29550,2670,6630,2400,20520,92,26,0,56.55,50.0,79,80,-6144,26076,0.07,-0.0201005025125629
2022-02-03,2022-02-04T07:22:40,2022-02-03T21:36:40,35160,31020,4140,6900,8250,15870,88,32,780,56.19,50.0,79,92,-8600,26560,0.0,-0.006366047745358094
2022-02-04,2022-02-05T07:57:00,2022-02-04T22:11:00,35160,29550,5610,5670,8310,15570,84,34,630,58.77,52.0,70,85,-6540,28620,-0.01,0.04591564335290976
2022-02-05,2022-02-06T07:51:07,2022-02-05T22:23:07,34080,29340,4740,6330,7860,15150,86,32,870,56.85,50.0,77,85,-5813,28267,0.08,-0.032669729453802976
2022-02-06,2022-02-07T07:01:52,2022-02-06T22:07:52,32040,28680,3360,6030,7620,15030,90,31,660,55.02,48.0,81,87,-6728,25312,0.09,-0.03218997361477571
2022-02-07,2022-02-08T07:03:59,2022-02-07T21:31:59,34320,28530,5790,5520,5820,17190,83,36,150,54.34,48.0,82,80,-8881,25439,-0.09,-0.012359142130134448
2022-02-08,2022-02-09T07:05:12,2022-02-08T21:56:12,32940,27540,5400,6330,7110,14100,84,32,1410,55.64,51.0,78,82,-7428,25512,-0.03,0.02392344497607657
2022-02-09,2022-02-10T07:03:29,2022-02-09T21:29:29,34440,30270,4170,6600,6780,16890,88,34,360,56.38,50.0,76,87,-9031,25409,-0.03,0.013299784327821751
2022-02-10,2022-02-11T07:05:15,2022-02-10T22:07:15,32280,28350,3930,4980,9270,14100,88,34,780,55.3,48.0,83,85,-6765,25515,0.05,-0.019155728981908537
2022-02-11,2022-02-12T08:16:20,2022-02-11T22:39:20,34620,29970,4650,6660,6960,16350,87,36,150,61.76,52.0,65,85,-4840,29780,0.15,0.11681735985533459
2022-02-12,2022-02-13T09:16:23,2022-02-12T22:45:23,37860,33000,4860,8460,7500,17040,87,32,690,64.12,55.0,57,91,-4477,33383,0.18,0.03821243523316076
2022-02-13,2022-02-14T07:01:13,2022-02-13T22:16:13,31500,29130,2370,6180,7320,15630,92,29,720,57.3,48.0,77,88,-6227,25273,0.07,-0.10636306924516548
2022-02-14,2022-02-15T07:04:00,2022-02-14T22:04:00,32400,28950,3450,7110,6870,14970,89,27,1440,58.08,51.0,69,88,-6960,25440,-0.35,0.013612565445026092
2022-02-15,2022-02-16T07:11:39,2022-02-15T23:21:39,28200,25590,2610,4290,6540,14760,91,29,1410,64.21,55.0,45,78,-2301,25899,-0.24,0.10554407713498626
2022-02-16,2022-02-17T07:07:55,2022-02-16T21:59:55,32880,29700,3180,6390,7410,15900,90,34,480,56.71,51.0,71,88,-7205,25675,-0.15,-0.11680423610029578
2022-02-17,2022-02-18T07:26:48,2022-02-17T22:14:48,33120,27240,5880,5520,8970,12750,82,26,1410,58.02,53.0,67,81,-6312,26808,-0.42,0.023099982366425742
2022-02-18,2022-02-19T08:38:00,2022-02-18T21:58:00,38400,33060,5340,9690,5520,17850,86,31,330,65.17,55.0,49,89,-7320,31080,0.12,0.12323336780420546
2022-02-19,2022-02-20T07:40:35,2022-02-19T22:21:35,33540,30270,3270,7080,8370,14820,90,26,960,60.67,53.0,54,91,-5905,27635,-0.23,-0.06905017646156208
2022-02-20,2022-02-21T07:01:59,2022-02-20T22:13:59,31680,27750,3930,7170,7620,12960,88,28,450,62.16,55.0,51,86,-6361,25319,0.19,0.024559090159881336
2022-02-21,2022-02-22T07:08:57,2022-02-21T22:23:57,31500,29100,2400,7320,6210,15570,92,28,780,60.56,55.0,50,90,-5763,25737,-0.02,-0.02574002574002565
2022-02-22,2022-02-23T07:03:28,2022-02-22T22:07:28,32160,30270,1890,8460,7320,14490,94,27,750,58.48,51.0,66,92,-6752,25408,0.14,-0.034346103038309206
2022-02-23,2022-02-24T07:11:07,2022-02-23T21:58:07,33180,29130,4050,6750,6030,16350,88,34,960,60.64,53.0,62,89,-7313,25867,0.03,0.0369357045143639
2022-02-24,2022-02-25T07:13:03,2022-02-24T22:36:03,31020,27750,3270,7020,5850,14880,89,37,510,59.21,52.0,62,84,-5037,25983,0.13,-0.023581794195250638
2022-02-25,2022-02-26T07:12:04,2022-02-25T22:18:04,32040,27420,4620,6090,8100,13230,86,31,1230,62.46,54.0,63,84,-6116,25924,0.06,0.05488937679446049
2022-02-26,2022-02-27T08:11:34,2022-02-26T20:46:34,41100,33990,7110,7110,7110,19770,83,35,570,61.47,51.0,69,89,-11606,29494,0.11,-0.015850144092219076
2022-02-27,2022-02-28T07:29:16,2022-02-27T22:32:16,32220,28800,3420,6450,6690,15660,89,35,690,59.44,51.0,69,87,-5264,26956,0.12,-0.033024239466406424
2022-02-28,2022-03-01T07:02:17,2022-02-28T22:03:17,32340,29730,2610,7380,7290,15060,92,31,600,58.37,50.0,65,90,-7003,25337,0.01,-0.018001345895020227
2022-03-01,2022-03-02T07:12:34,2022-03-01T21:56:34,33360,29520,3840,7020,6930,15570,88,31,630,58.22,49.0,77,89,-7406,25954,0.12,-0.00256981326023642
2022-03-02,2022-03-03T07:09:11,2022-03-02T22:06:11,32580,29190,3390,6060,8520,14610,90,29,840,57.09,50.0,82,89,-6829,25751,0.13,-0.019409137753349293
2022-03-03,2022-03-04T07:14:12,2022-03-03T21:30:12,35040,32580,2460,9960,6600,16020,93,30,390,57.33,49.0,77,92,-8988,26052,0.16,0.004203888596952199
2022-03-04,2022-03-05T07:55:41,2022-03-04T22:44:41,33060,28860,4200,7170,7710,13980,87,29,330,57.4,50.0,79,85,-4519,28541,0.09,0.0012210012210012167
2022-03-05,2022-03-06T08:24:28,2022-03-05T21:43:28,38460,33570,4890,8700,7920,16950,87,24,1560,60.78,52.0,65,91,-8192,30268,-0.08,0.0588850174216029
2022-03-06,2022-03-07T07:12:02,2022-03-06T21:55:02,33420,31230,2190,8100,6120,17010,93,28,510,56.49,49.0,78,91,-7498,25922,0.09,-0.07058242843040474
2022-03-07,2022-03-08T07:12:33,2022-03-07T22:11:33,32460,28230,4230,4890,8940,14400,87,32,240,54.52,48.0,89,83,-6507,25953,-0.17,-0.034873428925473515
2022-03-08,2022-03-09T07:03:12,2022-03-08T22:07:12,32160,29130,3030,7140,7380,14610,91,33,480,57.52,50.0,71,88,-6768,25392,0.05,0.05502567865003671
2022-03-09,2022-03-10T07:01:33,2022-03-09T22:16:33,31500,28530,2970,7290,9360,11880,91,27,930,56.18,49.0,72,90,-6207,25293,-0.05,-0.023296244784422826
2022-03-10,2022-03-11T07:02:16,2022-03-10T22:06:16,32160,29460,2700,7080,7740,14640,92,29,660,58.52,51.0,66,89,-6824,25336,-0.06,0.04165183339266654
2022-03-11,2022-03-12T07:44:14,2022-03-11T22:43:14,32460,28740,3720,6990,9540,12210,89,34,420,57.2,50.0,68,86,-4606,27854,0.04,-0.022556390977443663
2022-03-12,2022-03-13T08:22:14,2022-03-12T22:18:14,36240,32160,4080,6930,5880,19350,89,36,960,60.16,51.0,63,90,-6106,30134,0.03,0.051748251748251706
2022-03-13,2022-03-14T07:01:46,2022-03-13T22:15:46,31560,27570,3990,6660,7260,13650,87,29,660,55.38,48.0,86,86,-6254,25306,-0.03,-0.07945478723404242
2022-03-14,2022-03-15T07:01:58,2022-03-14T22:06:58,32100,28770,3330,6810,7410,14550,90,22,450,56.1,49.0,75,87,-6782,25318,-0.2,0.01300108342361872
2022-03-15,2022-03-16T07:02:55,2022-03-15T21:40:55,33720,29280,4440,7080,9240,12960,87,31,390,53.93,48.0,85,87,-8345,25375,-0.53,-0.03868092691622105
